##################
#                #
# ### ### ### ## #
# ###*###*###*## #
#                #
#     #######    #
#       *#       #
# ####   #   ### #
# #  #   #   #   #
# #  #       #   #
# ####   ### ### #
#    *   ### *   #
# #####      ### #
#                #
# ##**###*### ## #
##################