############################
# ...........##............#
# ####.#####.##.#####.####.#
# #  #.#   #.##.#   #.#  #.#
# ####.#####.##.#####.####.#
# .........................#
# ###..##. ##   ##....####.#
# ###..##. #     #....#  #.#
# ###..... #     #....#### #
#    .     #######    .....#
######     .......    .    #
#    # #  .................#
#    # #  .      ..........#
###### #  #      #..#.######
#.........#      #..#......#
######....#      #..#.######
############################